11
8
16 16 16 16 16 16 16 16 16 16 16 
16 9 9 9 9 9 9 9 9 9 16
16 9 9 9 9 9 9 9 9 9 16
16 9 9 9 9 9 9 9 9 9 16
16 9 9 9 9 9 9 9 9 9 16
16 9 9 9 9 9 9 9 9 9 16
16 9 9 9 9 9 9 9 9 9 16
16 16 16 16 16 16 16 16 16 16 16  